12
12
............
.##########.
.##.####.##.
.##..##..##.
.##########.
.##########.
.##..##..##.
.##.####.##.
.##########.
............