12
12
............
.#........#.
.##......##.
.###....###.
..###..###..
...######...
...######...
..###..###..
.###....###.
.##......##.
.#........#.
............